"Pathways"	"Common-Name"
PWY0-1312	"acetate formation from acetyl-CoA I"
COBALSYN-PWY	"adenosylcobalamin salvage from cobinamide I"
FUCCAT-PWY	"fucose degradation"
PWY-6890	"4-amino-2-methyl-5-diphosphomethylpyrimidine biosynthesis"
PWY-5340	"sulfate activation for sulfonation"
PWY-5669	"phosphatidylethanolamine biosynthesis I"
PWY0-461	"lysine degradation I"
PWY0-1299	"arginine dependent acid resistance"
PWY0-1305	"glutamate dependent acid resistance"
ORNDEG-PWY	"superpathway of ornithine degradation"
PWY-46	"putrescine biosynthesis III"
PWY-6282	"palmitoleate biosynthesis I"
PWY-5971	"palmitate biosynthesis II (bacteria and plants)"
GLUAMCAT-PWY	"<i>N</i>-acetylglucosamine degradation I"
PWY-5965	"fatty acid biosynthesis initiation III"
PWY-5989	"stearate biosynthesis II (bacteria and plants)"
FASYN-ELONG-PWY	"fatty acid elongation -- saturated"
PYRUVOX-PWY	"pyruvate oxidation pathway"
CYANCAT-PWY	"cyanate degradation"
PWY-5155	"&beta;-alanine biosynthesis III"
PWY-5852	"demethylmenaquinol-8 biosynthesis I"
PWY0-1356	"formate to dimethyl sulfoxide electron transfer"
PWY0-1321	"nitrate reduction III (dissimilatory)"
PWY0-1355	"formate to trimethylamine <i>N</i>-oxide electron transfer"
GLYCOLYSIS-TCA-GLYOX-BYPASS	"superpathway of glycolysis, pyruvate dehydrogenase, TCA, and glyoxylate bypass"
PWY0-1352	"nitrate reduction VIII (dissimilatory)"
PWY0-1353	"succinate to cytochrome <i>bd</i> oxidase electron transfer"
PWY0-1334	"NADH to cytochrome <i>bd</i> oxidase electron transfer"
PWY-6894	"thiamin diphosphate biosynthesis I (E. coli)"
PWY0-1329	"succinate to cytochrome <i>bo</i> oxidase electron transfer"
PWY0-1335	"NADH to cytochrome <i>bo</i> oxidase electron transfer"
PWY-7222	"guanosine deoxyribonucleotides <i>de novo</i> biosynthesis II"
PWY0-1465	"D-malate degradation"
PWY-7220	"adenosine deoxyribonucleotides <i>de novo</i> biosynthesis II"
GALACTMETAB-PWY	"galactose degradation I (Leloir pathway)"
PWY-7179	"purine deoxyribonucleosides degradation"
HCAMHPDEG-PWY	"3-phenylpropanoate and 3-(3-hydroxyphenyl)propanoate degradation to 2-oxopent-4-enoate"
PWY-7219	"adenosine ribonucleotides <i>de novo</i> biosynthesis"
PWY0-1301	"melibiose degradation"
BGALACT-PWY	"lactose degradation III"
PWY0-44	"D-allose degradation"
TRNA-CHARGING-PWY	"tRNA charging"
PWY0-1182	"trehalose degradation II (trehalase)"
PWY0-1466	"trehalose degradation VI (periplasmic)"
PWY0-1415	"superpathway of heme biosynthesis from uroporphyrinogen-III"
HEMESYN2-PWY	"heme biosynthesis from uroporphyrinogen-III II (anaerobic)"
HEME-BIOSYNTHESIS-II	"heme biosynthesis from uroporphyrinogen-III I (aerobic)"
PWY-6690	"cinnamate and 3-hydroxycinnamate degradation to 2-oxopent-4-enoate"
RIBOKIN-PWY	"ribose degradation"
PWY0-1527	"curcumin degradation"
PWY-6961	"L-ascorbate degradation II (bacterial, aerobic)"
DTDPRHAMSYN-PWY	"dTDP-L-rhamnose biosynthesis I"
PPGPPMET-PWY	"ppGpp biosynthesis"
NADPHOS-DEPHOS-PWY	"NAD phosphorylation and dephosphorylation I"
PWY0-981	"taurine degradation IV"
NONOXIPENT-PWY	"pentose phosphate pathway (non-oxidative branch)"
PWY0-301	"L-ascorbate degradation I (bacterial, anaerobic)"
ASPARAGINESYN-PWY	"asparagine biosynthesis II"
ASPASN-PWY	"superpathway of aspartate and asparagine biosynthesis; interconversion of aspartate and asparagine"
ASPARAGINE-DEG1-PWY	"asparagine degradation I"
ALANINE-VALINESYN-PWY	"alanine biosynthesis I"
VALSYN-PWY	"valine biosynthesis"
UDPNAGSYN-PWY	"UDP-<i>N</i>-acetyl-D-glucosamine biosynthesis I"
PWY-7176	"UTP and CTP <i>de novo</i> biosynthesis"
PWY-7221	"guanosine ribonucleotides <i>de novo</i> biosynthesis"
ASPARTATESYN-PWY	"aspartate biosynthesis"
MALATE-ASPARTATE-SHUTTLE-PWY	"aspartate degradation II"
GLUTDEG-PWY	"glutamate degradation II"
ASPARAGINE-BIOSYNTHESIS	"asparagine biosynthesis I"
PWY0-1338	"polymyxin resistance"
AST-PWY	"arginine degradation II (AST pathway)"
DAPLYSINESYN-PWY	"lysine biosynthesis I"
PUTDEG-PWY	"putrescine degradation I"
TYRSYN	"tyrosine biosynthesis I"
ALANINE-SYN2-PWY	"alanine biosynthesis II"
PWYCQD-2	"dTDP-<i>N</i>-acetylviosamine biosynthesis"
HISTDEG-PWY	"histidine degradation IV"
GLUTAMINDEG-PWY	"glutamine degradation I"
GLUTSYN-PWY	"glutamate biosynthesis I"
GLUTAMINEFUM-PWY	"glutamine degradation II"
GLUTATHIONESYN-PWY	"glutathione biosynthesis"
PWY-5188	"tetrapyrrole biosynthesis I (from glutamate)"
PWY-2161	"folate polyglutamylation"
HISTSYN-PWY	"histidine biosynthesis"
GLUTSYNIII-PWY	"glutamate biosynthesis III"
PROSYN-PWY	"proline biosynthesis I"
PWY0-1221	"putrescine degradation II"
GLNSYN-PWY	"glutamine biosynthesis I"
ILEUSYN-PWY	"isoleucine biosynthesis I (from threonine)"
LEUSYN-PWY	"leucine biosynthesis"
PHESYN	"phenylalanine biosynthesis I"
RIBOSYN2-PWY	"flavin biosynthesis I (bacteria and plants)"
ARGSYN-PWY	"arginine biosynthesis I (via L-ornithine)"
HOMOSER-THRESYN-PWY	"threonine biosynthesis from homoserine"
HOMOSERSYN-PWY	"homoserine biosynthesis"
PWY-40	"putrescine biosynthesis I"
PWY0-823	"arginine degradation III (arginine decarboxylase/agmatinase pathway)"
GALACTITOLCAT-PWY	"galactitol degradation"
PWY-6387	"UDP-<i>N</i>-acetylmuramoyl-pentapeptide biosynthesis I (<i>meso</i>-DAP-containing)"
MANNIDEG-PWY	"mannitol degradation I"
PWY0-1535	"D-serine degradation"
HOMOSER-METSYN-PWY	"methionine biosynthesis I"
PWY0-521	"fructoselysine and psicoselysine degradation"
PWY-6151	"<i>S</i>-adenosyl-L-methionine cycle I"
PWY0-1347	"NADH to trimethylamine <i>N</i>-oxide electron transfer"
PWY-6153	"autoinducer AI-2 biosynthesis I"
PWY0-1336	"NADH to fumarate electron transfer"
THRDLCTCAT-PWY	"threonine degradation III (to methylglyoxal)"
PWY0-1348	"NADH to dimethyl sulfoxide electron transfer"
THREONINE-DEG2-PWY	"threonine degradation II"
PWY-6019	"pseudouridine degradation"
PWY-5686	"UMP biosynthesis"
PWY0-1314	"fructose degradation"
GLUTORN-PWY	"ornithine biosynthesis"
LCYSDEG-PWY	"L-cysteine degradation II"
ALADEG-PWY	"alanine degradation I"
SERDEG-PWY	"L-serine degradation"
PWY0-1261	"anhydromuropeptides recycling"
PWY-7346	"UDP-&alpha;-D-glucuronate biosynthesis (from UDP-glucose)"
PEPTIDOGLYCANSYN-PWY	"peptidoglycan biosynthesis I (<I>meso</I>-diaminopimelate containing)"
COLANSYN-PWY	"colanic acid building blocks biosynthesis"
PWY-7344	"UDP-D-galactose biosynthesis"
OANTIGEN-PWY-1	"<i>O</i>-antigen building blocks biosynthesis (<i>E. coli</i>)"
PWY-5194	"siroheme biosynthesis"
BETSYN-PWY	"glycine betaine biosynthesis I (Gram-negative bacteria)"
PWY-6708	"ubiquinol-8 biosynthesis (prokaryotic)"
PWY-4621	"arsenate detoxification II (glutaredoxin)"
PWY0-541	"cyclopropane fatty acid (CFA) biosynthesis"
PWY-7335	"UDP-<i>N</i>-acetyl-&alpha;-D-mannosaminouronate biosynthesis"
PWY0-1507	"biotin biosynthesis from 8-amino-7-oxononanoate I"
PWY-66	"GDP-L-fucose biosynthesis I (from GDP-D-mannose)"
PWY-6268	"adenosylcobalamin salvage from cobalamin"
PWY-5901	"2,3-dihydroxybenzoate biosynthesis"
GLUCONSUPER-PWY	"D-gluconate degradation"
LIPA-CORESYN-PWY	"Lipid A-core biosynthesis"
KDO-NAGLIPASYN-PWY	"superpathway of (KDO)<SUB>2</SUB>-lipid A biosynthesis"
PWY-6700	"queuosine biosynthesis"
KDO-LIPASYN-PWY	"(KDO)<sub>2</sub>-lipid A biosynthesis I"
MENAQUINONESYN-PWY	"menaquinol-8 biosynthesis"
ECASYN-PWY	"enterobacterial common antigen biosynthesis"
PLPSAL-PWY	"pyridoxal 5'-phosphate salvage I"
PWY-6519	"8-amino-7-oxononanoate biosynthesis I"
PWY-6617	"adenosine nucleotides degradation III"
PWY-5755	"4-hydroxybenzoate biosynthesis II (bacteria and fungi)"
PWY0-1275	"lipoate biosynthesis and incorporation II"
PWY0-501	"lipoate biosynthesis and incorporation I"
KDOSYN-PWY	"KDO transfer to lipid IV<sub>A</sub> I"
SAM-PWY	"S-adenosyl-L-methionine biosynthesis"
CYSTSYN-PWY	"cysteine biosynthesis I"
PWY-5443	"aminopropanol phosphate biosynthesis I"
SERSYN-PWY	"serine biosynthesis"
PANTO-PWY	"phosphopantothenate biosynthesis I"
PWY-7247	"&beta;-D-glucuronide and D-glucuronate degradation"
PYRIDNUCSAL-PWY	"NAD salvage pathway I"
PWY3O-4106	"NAD salvage pathway III"
GALACTUROCAT-PWY	"D-galacturonate degradation I"
PYRIDNUCSYN-PWY	"NAD biosynthesis I (from aspartate)"
PWY-1269	"CMP-KDO biosynthesis I"
PWY0-1306	"L-galactonate degradation"
GALACTCAT-PWY	"D-galactonate degradation"
KETOGLUCONMET-PWY	"ketogluconate metabolism"
PWY-6430	"thymine degradation"
PWY0-1021	"alanine biosynthesis III"
PWY-6703	"preQ<sub>0</sub> biosynthesis"
GLYCOLATEMET-PWY	"glycolate and glyoxylate degradation I"
GALACTARDEG-PWY	"D-galactarate degradation I"
GLUCARDEG-PWY	"<i>D</i>-glucarate degradation I"
PWY0-1300	"2-<I>O</I>-&alpha;-mannosyl-D-glycerate degradation"
PWY-5705	"allantoin degradation to glyoxylate III"
PWY-5698	"allantoin degradation to ureidoglycolate II (ammonia producing)"
PWY0-1471	"uracil degradation III"
PWY-3982	"uracil degradation I (reductive)"
PWY0-41	"allantoin degradation IV (anaerobic)"
PWY0-163	"salvage pathways of pyrimidine ribonucleotides"
PWY-6556	"pyrimidine ribonucleosides salvage II"
PWY0-1295	"pyrimidine ribonucleosides degradation"
PWY-6611	"adenine and adenosine salvage V"
PWY-6618	"guanine and guanosine salvage III"
PWY-6608	"guanosine nucleotides degradation III"
PWY-6605	"adenine and adenosine salvage II"
PWY0-1296	"purine ribonucleosides degradation"
PWY-6609	"adenine and adenosine salvage III"
SALVADEHYPOX-PWY	"adenosine nucleotides degradation II"
PWY0-181	"salvage pathways of pyrimidine deoxyribonucleotides"
PWY-7181	"pyrimidine deoxyribonucleosides degradation"
NAGLIPASYN-PWY	"lipid IV<sub>A</sub> biosynthesis"
PWY-6123	"inosine-5'-phosphate biosynthesis I"
TRYPDEG-PWY	"tryptophan degradation II (via pyruvate)"
TRPSYN-PWY	"tryptophan biosynthesis"
PANTOSYN-PWY	"pantothenate and coenzyme A biosynthesis I"
PWY0-1337	"oleate &beta;-oxidation"
COA-PWY	"coenzyme A biosynthesis"
PWY-4381	"fatty acid biosynthesis initiation I"
PWY0-1264	"biotin-carboxyl carrier protein assembly"
PWY-7315	"dTDP-<i>N</i>-acetylthomosamine biosynthesis"
PWY-6612	"superpathway of tetrahydrofolate biosynthesis"
PWY0-1324	"<i>N</i>-acetylneuraminate and <i>N</i>-acetylmannosamine degradation"
GLYOXYLATE-BYPASS	"glyoxylate cycle"
GLYOXDEG-PWY	"glycolate and glyoxylate degradation II"
PWY-5485	"pyruvate fermentation to acetate IV"
PWY-5480	"pyruvate fermentation to ethanol I"
FERMENTATION-PWY	"mixed acid fermentation"
ANARESP1-PWY	"respiration (anaerobic)"
FAO-PWY	"fatty acid &beta;-oxidation I"
PWY-5667	"CDP-diacylglycerol biosynthesis I"
PWY-5084	"2-oxoglutarate decarboxylation to succinyl-CoA"
PYRUVDEHYD-PWY	"pyruvate decarboxylation to acetyl CoA"
PWY-5794	"malonate degradation I (biotin-independent)"
PWY-5148	"acyl-CoA hydrolysis"
PWY-5837	"1,4-dihydroxy-2-naphthoate biosynthesis I"
FASYN-INITIAL-PWY	"superpathway of fatty acid biosynthesis initiation (E. coli)"
PWY-5966	"fatty acid biosynthesis initiation II"
PWY0-1313	"acetate conversion to acetyl-CoA"
TCA	"TCA cycle I (prokaryotic)"
PWY0-522	"lipoate salvage I"
AMMASSIM-PWY	"ammonia assimilation cycle III"
PWY-6823	"molybdenum cofactor biosynthesis"
PWY-6147	"6-hydroxymethyl-dihydropterin diphosphate biosynthesis I"
GLCMANNANAUT-PWY	"superpathway of <i>N</i>-acetylglucosamine, <i>N</i>-acetylmannosamine and <i>N</i>-acetylneuraminate degradation"
PWY0-1433	"tetrahydromonapterin biosynthesis"
PWY-6614	"tetrahydrofolate biosynthesis"
P4-PWY	"superpathway of lysine, threonine and methionine biosynthesis I"
1CMET2-PWY	"formylTHF biosynthesis"
PWY0-166	"superpathway of pyrimidine deoxyribonucleotides <i>de novo</i> biosynthesis (E. coli)"
PWY-6579	"superpathway of guanine and guanosine salvage"
PWY-7187	"pyrimidine deoxyribonucleotides <i>de novo</i> biosynthesis II"
PWY-7184	"pyrimidine deoxyribonucleotides <i>de novo</i> biosynthesis I"
PWY0-881	"superpathway of fatty acid biosynthesis I (E. coli)"
GLYCOL-GLYOXDEG-PWY	"superpathway of glycol metabolism and degradation"
GLYCLEAV-PWY	"glycine cleavage"
GLYSYN-PWY	"glycine biosynthesis I"
PWY-6629	"superpathway of tryptophan biosynthesis"
PWY-5973	"<i>cis</i>-vaccenate biosynthesis"
SULFATE-CYS-PWY	"superpathway of sulfate assimilation and cysteine biosynthesis"
BIOTIN-BIOSYNTHESIS-PWY	"biotin biosynthesis I"
THIOREDOX-PWY	"thioredoxin pathway"
HEXITOLDEGSUPER-PWY	"superpathway of hexitol degradation (bacteria)"
PWY-5964	"guanylyl molybdenum cofactor biosynthesis"
PWY-6476	"cytidylyl molybdenum cofactor biosynthesis"
POLYISOPRENSYN-PWY	"polyisoprenoid biosynthesis (<i>E. coli</i>)"
PWY0-1319	"CDP-diacylglycerol biosynthesis II"
PWY0-1297	"superpathway of purine deoxyribonucleosides degradation"
GLYCOLYSIS	"glycolysis I (from glucose-6P)"
PWY-5484	"glycolysis II (from fructose-6P)"
THREOCAT-PWY	"superpathway of threonine metabolism"
GLUCONEO-PWY	"gluconeogenesis I"
LPSSYN-PWY	"superpathway of lipopolysaccharide biosynthesis"
METSYN-PWY	"homoserine and methionine biosynthesis"
PWY-6126	"superpathway of adenosine nucleotides <i>de novo</i> biosynthesis II"
PWY0-1479	"tRNA processing"
PWY0-1544	"proline to cytochrome <i>bo</i> oxidase electron transfer"
PWY0-381	"glycerol and glycerophosphodiester degradation"
PWY0-42	"2-methylcitrate cycle I"
PWY0-43	"conversion of succinate to propionate"
ALL-CHORISMATE-PWY	"superpathway of chorismate metabolism"
GLYCEROLMETAB-PWY	"glycerol degradation V"
GALACT-GLUCUROCAT-PWY	"superpathway of hexuronide and hexuronate degradation"
PWY-5668	"cardiolipin biosynthesis I"
PWY-6284	"superpathway of unsaturated fatty acids biosynthesis (<i>E. coli</i>)"
PWY0-845	"superpathway of pyridoxal 5'-phosphate biosynthesis and salvage"
ARGDEG-PWY	"superpathway of arginine, putrescine, and 4-aminobutyrate degradation"
PWY0-862	"<i>cis</i>-dodecenoyl biosynthesis"
GLUCUROCAT-PWY	"superpathway of &beta;-D-glucuronide and D-glucuronate degradation"
GLYCOGENSYNTH-PWY	"glycogen biosynthesis I (from ADP-D-Glucose)"
PENTOSE-P-PWY	"pentose phosphate pathway"
PWY0-1241	"ADP-L-<i>glycero</i>-&beta;-D-<i>manno</i>-heptose biosynthesis"
PWY-6892	"thiazole biosynthesis I (E. coli)"
PWY-6628	"superpathway of phenylalanine biosynthesis"
POLYAMSYN-PWY	"superpathway of polyamine biosynthesis I"
GLYCOCAT-PWY	"glycogen degradation I"
PWY0-1277	"3-phenylpropionate and 3-(3-hydroxyphenyl)propionate degradation"
THISYN-PWY	"superpathway of thiamin diphosphate biosynthesis I"
PWY0-1325	"superpathway of asparagine biosynthesis"
PWY-5437	"threonine degradation I"
SORBDEG-PWY	"D-sorbitol degradation II"
MANNCAT-PWY	"D-mannose degradation"
UBISYN-PWY	"superpathway of ubiquinol-8 biosynthesis (prokaryotic)"
PWY-5659	"GDP-mannose biosynthesis"
DENOVOPURINE2-PWY	"superpathway of purine nucleotides <i>de novo</i> biosynthesis II"
ACETOACETATE-DEG-PWY	"acetoacetate degradation (to acetyl CoA)"
PWY-7343	"UDP-glucose biosynthesis"
GLUCOSE1PMETAB-PWY	"glucose and glucose-1-phosphate degradation"
METHGLYUT-PWY	"superpathway of methylglyoxal degradation"
TRESYN-PWY	"trehalose biosynthesis I"
PWY-6125	"superpathway of guanosine nucleotides <i>de novo</i> biosynthesis II"
PWY0-1545	"cardiolipin biosynthesis III"
ACETATEUTIL-PWY	"superpathway of acetate utilization and formation"
PWY-4261	"glycerol degradation I"
PWY-6952	"glycerophosphodiester degradation"
FUC-RHAMCAT-PWY	"superpathway of fucose and rhamnose degradation"
PWY-5350	"thiosulfate disproportionation III (rhodanese)"
GLUT-REDOX-PWY	"glutathione redox reactions II"
ORNARGDEG-PWY	"superpathway of arginine and ornithine degradation"
PWY-4121	"glutathionylspermidine biosynthesis"
PWY0-781	"aspartate superpathway"
PWY-5386	"methylglyoxal degradation I"
PWY-1801	"formaldehyde oxidation II (glutathione-dependent)"
ARG+POLYAMINE-SYN	"superpathway of arginine and polyamine biosynthesis"
PWYCQD-3	"N-acetyl-galactosamine degradation"
GLUCARGALACTSUPER-PWY	"superpathway of D-glucarate and D-galactarate degradation"
SER-GLYSYN-PWY	"superpathway of serine and glycine biosynthesis I"
DETOX1-PWY	"superoxide radicals degradation"
PWY0-1280	"ethylene glycol degradation"
ARO-PWY	"chorismate biosynthesis I"
2PHENDEG-PWY	"phenylethylamine degradation I"
PWY0-1315	"L-lactaldehyde degradation (anaerobic)"
PWY0-1317	"L-lactaldehyde degradation (aerobic)"
PHOSLIPSYN-PWY	"phospholipid biosynthesis I"
PWY-6772	"hydrogen production V"
PWY0-1061	"superpathway of alanine biosynthesis"
PWY-901	"methylglyoxal degradation II"
TCA-GLYOX-BYPASS	"superpathway of glyoxylate bypass and TCA"
ETOH-ACETYLCOA-ANA-PWY	"ethanol degradation I"
PWY-6028	"acetoin degradation"
BRANCHED-CHAIN-AA-SYN-PWY	"superpathway of leucine, valine, and isoleucine biosynthesis"
PWY-5162	"2-oxopentenoate degradation"
PWY-5436	"threonine degradation IV"
PRPP-PWY	"superpathway of histidine, purine, and pyrimidine biosynthesis"
PWY0-1477	"ethanolamine utilization"
PWY-7180	"2'-deoxy-&alpha;-D-ribose 1-phosphate degradation"
PWY0-1298	"superpathway of pyrimidine deoxyribonucleosides degradation"
DARABCAT-PWY	"D-arabinose degradation II"
XYLCAT-PWY	"xylose degradation I"
THRESYN-PWY	"threonine biosynthesis"
P2-PWY	"citrate lyase activation"
COMPLETE-ARO-PWY	"superpathway of phenylalanine, tyrosine, and tryptophan biosynthesis"
ARABCAT-PWY	"L-arabinose degradation I"
NONMEVIPP-PWY	"methylerythritol phosphate pathway"
MET-SAM-PWY	"superpathway of <i>S</i>-adenosyl-L-methionine biosynthesis"
LYXMET-PWY	"L-lyxose degradation"
PWYCQD-4	"galactosamine degradation"
PWY-5838	"superpathway of menaquinol-8 biosynthesis I"
PWY-7242	"D-fructuronate degradation"
ENTNER-DOUDOROFF-PWY	"Entner-Doudoroff pathway I"
PWY0-162	"superpathway of pyrimidine ribonucleotides <i>de novo</i> biosynthesis"
PWY-6012	"acyl carrier protein metabolism I"
4AMINOBUTMETAB-PWY	"superpathway of 4-aminobutyrate degradation"
SO4ASSIM-PWY	"sulfate reduction I (assimilatory)"
PWY-6163	"chorismate biosynthesis from 3-dehydroquinate"
PWY-6164	"3-dehydroquinate biosynthesis I"
PWY0-1534	"hydrogen sulfide biosynthesis I"
PWY-5785	"di-<i>trans</i>,poly-<i>cis</i>-undecaprenyl phosphate biosynthesis"
PWY-5783	"octaprenyl diphosphate biosynthesis"
PWY-5123	"<i>trans, trans</i>-farnesyl diphosphate biosynthesis"
PWY-6543	"4-aminobenzoate biosynthesis"
PWY-6535	"4-aminobutyrate degradation"
PWY-6537	"4-aminobutyrate degradation II"
PWY-7446	"sulfoglycolysis"
PWY0-901	"selenocysteine biosynthesis I (bacteria)"
3-HYDROXYPHENYLACETATE-DEGRADATION-PWY	"4-hydroxyphenylacetate degradation"
TREDEGLOW-PWY	"trehalose degradation I (low osmolarity)"
PYRIDOXSYN-PWY	"pyridoxal 5'-phosphate biosynthesis I"
IDNCAT-PWY	"L-idonate degradation"
OXIDATIVEPENT-PWY	"pentose phosphate pathway (oxidative branch) I"
GLYCOLYSIS-E-D	"superpathway of glycolysis and Entner-Doudoroff"
SALVPURINE2-PWY	"xanthine and xanthosine salvage"
PWY-6620	"guanine and guanosine salvage"
PWY0-661	"PRPP biosynthesis II"
PWY0-662	"PRPP biosynthesis I"
BSUBPOLYAMSYN-PWY	"spermidine biosynthesis I"
PWY0-1303	"aminopropylcadaverine biosynthesis"
RHAMCAT-PWY	"L-rhamnose degradation I"
PWY-6277	"superpathway of 5-aminoimidazole ribonucleotide biosynthesis"
PWY-6122	"5-aminoimidazole ribonucleotide biosynthesis II"
PWY-6121	"5-aminoimidazole ribonucleotide biosynthesis I"
PWY0-1309	"chitobiose degradation"
PWY0-1517	"sedoheptulose bisphosphate bypass"
PWY-5453	"methylglyoxal degradation III"
